NO    ./textures/brick.png
SO ./textures/grass.png
WE ./textures/wood.png
EA ./textures/wood2.png
F 100,100,100
C 100,100,500

 11111111111
1011101 10N1
1111111  1111 1
    11 1111111
