NO ./textures/brick.png
SO ./textures/grass.png
WE ./textures/wood.png
EA ./textures/wood2.png
F 49,51,51
C 102,204,209

1111111111111111111111111111
1N01010101010101010100000001
1000000000000000000000000001
1000000000000000000000000001
1000000000000000000000111111
10000000000000000000001
10000000000000000000001
10000000000000000000001
10000000000000000000001
10000000000000000000001
10000000000000000000001
10000000000000000000001
10000000000000000000001
10000000000000000000001
10000000000000000000001
10000000000000000000001
10000000000000000000001
10000000000000000000001
10000000000000000000001
10000000000000000000001
11111111111111111111111
