NO ./textures/brick.png
SO ./textures/grass.png
WE ./textures/wood.png
EA ./textures/wood2.png
F 100,100,100
C 100,100,100

111111111
1000001N1
111111111
