        NO ./textures/key20.png
SO 							./textures/key20.png




WE ./textures/key20.png
EA ./textures/key20.png
F	190,178,123




C 135,206,235




111111111
1000001N1
111111111
111
