NO ./textures/wolf/wood.png
SO ./textures/wolf/redbrick.png
WE ./textures/wolf/pillar.png
EA ./textures/wolf/eagle.png
F 210,50,100
C 20,250,100

111111111111111111111
100000000000000000001
100011001111111111111
100N00001
111111111
