NO ./textures/hive.png
SO ./textures/grass.png
WE ./textures/wood.png
EA ./textures/wood2.png
F 210,50,100
C 20,250,100

1111111111
1000000001
1000110001
100N000001
1111111111
