NO ./textures/brick.png
SO ./textures/grass.png
WE ./textures/wood.png
EA ./textures/wood2.png
F 210,50,100
C 20,250,100

111111111111111111111111111111111111111111111111111111111111111111111111111111111111111111111
100000000000000000000000000000000000000000000000000000000000000000000000000000000000000000001
100000000000000000000000000000000000000000000000000000000000000000000000000000000000000000001
100000000000000000000000000000000000000000000000000000000000000000000000000000000000000000001
100000000000000000000000011111111111110000000000000000000000000000000000000000000000000000001
10000000000000000000000001           10000000000000000000000000000000000000000000011111111111
10000000000000000000000001           1000000000000000000000000000000000000000000001
10000000000000000000000001           1000000000000000000000000000000000000000000001
10000000000000000000000001           10000000000000000000000000000000000000000000011111111111
100000000000000000000000011111111111110000000000000000000000000000000000000000000000000000001
100000000000000000000000000000000000000000000000000000000000000000000000000000000000000000001
100000000000000000000000000000000000000000000000000000000000000000000000000000000000000000001
100000000000000000000000000000000000000000000000000000000000000000000000000000000000000000001
100000000000000000000000000000000000000000000000000000000000000000000000000000000000000000001
100000000000000000000000000000000000000000000000000000000000000000000000000000000000000000001
100000000000000000000000000000000000000000000000000000000000000000000000000000000000000000001
100011001111111111111111111111111111111111111111111111111111111111111111111111111111111111111
100N00001
111110001111111111111111111111111111111111111111111111111111111111111111111111111111111111111
100000000000000000000000000000000000000000000000000000000000000000000000000000000000000000001
100000000000000000000000000000000000000000000000000000000000000000000000000000000000000000001
100000000000000000000000000000000000000000000000000000000000000000000000000000000000000000001
100000000000000000000000000000000000000000000000000000000000000000000000000000000000000000001
111111100000000000000000000000000000000000000000000000000000000000000000000000000000000000001
      100000000000000000000000000000000000000000000000000000000000000000000000000000000000001
      100000000000000000000000000000000000000000000000000000000000000000000000000000000000001
      100000000000000000000000000000000000000000000000000000000000000000000000000000000000001
111111111111111111111111111111111111111111111111111111111111111111111111111111111111111111101
                                                                                          101
                                                                                          101
                                                                                          101
                                                                                          101
                                                                                          111
