NO ./textures/brick.png
SO ./textures/grass.png
WE ./textures/wood.png
EA ./textures/wood2.png
F 49,51,51
C 102,204,209

11111111
10000001
10011001
10000001
10N00001
11111111
